country,year,share_bottom,share_top,share_upper,income_mean_bottom,income_mean_upper,income_mean_top,multiple,income_mean_gap
canada,1820,0.12,0.175,0.705,32339,167003,2031280,62.800000000000004,1998941
canada,1850,0.1289,0.117,0.7541,35430,178634,1358056,38.300000000000004,1322626
canada,1880,0.1262,0.12,0.7538,34492,178563,1392878,40.300000000000004,1358386
canada,1900,0.1241,0.12,0.7559,33763,179060,1392878,41.2,1359115
canada,1910,0.12,0.122,0.758,32339,179558,1416093,43.7,1383754
canada,1920,0.1985,0.1041,0.6974,59604,165202,1208321,20.200000000000003,1148717
canada,1921,0.1634,0.1375,0.6991,47413,165605,1596006,33.6,1548593
canada,1922,0.1911,0.1131,0.6958,57034,164823,1312787,23.0,1255753
canada,1923,0.2081,0.1043,0.6876,62938,162881,1210643,19.200000000000003,1147705
canada,1924,0.2061,0.1054,0.6885000000000001,62244,163094,1223411,19.6,1161167
canada,1925,0.2094,0.0953,0.6953,63390,164705,1106177,17.400000000000002,1042787
canada,1926,0.208,0.1011,0.6909000000000001,62903,163663,1173500,18.6,1110597
canada,1927,0.2063,0.106,0.6877,62313,162905,1230375,19.700000000000003,1168062
canada,1928,0.2037,0.1112,0.6851,61410,162289,1290733,21.0,1229323
canada,1929,0.2024,0.1138,0.6838,60958,161981,1320912,21.6,1259954
canada,1930,0.1981,0.1178,0.6840999999999999,59465,162052,1367342,22.900000000000002,1307877
canada,1931,0.1842,0.1252,0.6906,54637,163592,1453236,26.5,1398599
canada,1932,0.1689,0.1364,0.6947000000000001,49323,164563,1583238,32.0,1533915
canada,1933,0.1623,0.1411,0.6966,47031,165013,1637792,34.800000000000004,1590761
canada,1934,0.1623,0.1411,0.6966,47031,165013,1637792,34.800000000000004,1590761
canada,1935,0.1751,0.1299,0.695,51477,164634,1507790,29.200000000000003,1456313
canada,1936,0.1751,0.1299,0.695,51477,164634,1507790,29.200000000000003,1456313
canada,1937,0.1855,0.1224,0.6921,55089,163947,1420735,25.700000000000003,1365646
canada,1938,0.1685,0.1427,0.6888,49184,163165,1656364,33.6,1607180
canada,1939,0.1792,0.1284,0.6924,52901,164018,1490379,28.1,1437478
canada,1940,0.1929,0.11,0.6971,57659,165131,1276805,22.1,1219146
canada,1941,0.2052,0.0972,0.6976,61931,165250,1128231,18.2,1066300
canada,1942,0.2203,0.081,0.6987000000000001,67176,165510,940192,13.9,873016
canada,1943,0.2214,0.0769,0.7017,67558,166221,892602,13.200000000000001,825044
canada,1944,0.2257,0.0715,0.7028,69051,166482,829923,12.0,760872
canada,1945,0.2259,0.0727,0.7014,69121,166150,843852,12.200000000000001,774731
canada,1946,0.2246,0.0771,0.6983,68669,165416,894924,13.0,826255
canada,1947,0.224,0.0791,0.6969000000000001,68461,165084,918138,13.4,849677
canada,1948,0.2276,0.0745,0.6979,69711,165321,864745,12.4,795034
canada,1949,0.2239,0.0773,0.6988,68426,165534,897245,13.100000000000001,828819
canada,1950,0.2239,0.0785,0.6976,68426,165250,911174,13.3,842748
canada,1951,0.2287,0.0717,0.6996,70093,165724,832244,11.8,762151
canada,1952,0.2288,0.0706,0.7006,70128,165960,819476,11.600000000000001,749348
canada,1953,0.2261,0.0711,0.7028000000000001,69190,166482,825280,11.9,756090
canada,1954,0.223,0.0749,0.7021000000000001,68113,166316,869388,12.700000000000001,801275
canada,1955,0.224,0.0734,0.7026,68461,166434,851977,12.4,783516
canada,1956,0.2265,0.0693,0.7041999999999999,69329,166813,804387,11.600000000000001,735058
canada,1957,0.2247,0.0699,0.7054,68704,167098,811351,11.8,742647
canada,1958,0.2236,0.0716,0.7048,68322,166955,831084,12.100000000000001,762762
canada,1959,0.2235,0.0707,0.7058,68287,167192,820637,12.0,752350
canada,1960,0.2223,0.0715,0.7061999999999999,67870,167287,829923,12.200000000000001,762053
canada,1961,0.2208,0.0727,0.7065,67349,167358,843852,12.5,776503
canada,1962,0.2245,0.0687,0.7068,68634,167429,797422,11.600000000000001,728788
canada,1963,0.2255,0.0669,0.7076,68982,167619,776529,11.200000000000001,707547
canada,1964,0.2246,0.0687,0.7067,68669,167405,797422,11.600000000000001,728753
canada,1965,0.2265,0.0671,0.7063999999999999,69329,167334,778851,11.200000000000001,709522
canada,1966,0.2279,0.0648,0.7073,69815,167548,752154,10.700000000000001,682339
canada,1967,0.2267,0.0658,0.7075,69398,167595,763761,11.0,694363
canada,1968,0.2261,0.066,0.7079,69190,167690,766083,11.0,696893
canada,1969,0.2259,0.066,0.7081,69121,167737,766083,11.0,696962
canada,1970,0.2245,0.0662,0.7092999999999999,68634,168021,768404,11.100000000000001,699770
canada,1971,0.2249,0.0649,0.7102,68773,168235,753315,10.9,684542
canada,1972,0.2251,0.0646,0.7103,68843,168258,749832,10.8,680989
canada,1973,0.2254,0.0667,0.7079,68947,167690,774208,11.200000000000001,705261
canada,1974,0.2246,0.0668,0.7086,68669,167856,775368,11.200000000000001,706699
canada,1975,0.2207,0.0742,0.7051,67314,167026,861263,12.700000000000001,793949
canada,1976,0.2229,0.0684,0.7087,68079,167879,793940,11.600000000000001,725861
canada,1977,0.2247,0.0653,0.71,68704,168187,757957,11.0,689253
canada,1978,0.2238,0.067,0.7092,68391,167998,777690,11.3,709299
canada,1979,0.223,0.0716,0.7054,68113,167098,831084,12.200000000000001,762971
canada,1980,0.2197,0.076,0.7043,66967,166837,882156,13.100000000000001,815189
canada,1981,0.2239,0.0708,0.7053,68426,167074,821798,12.0,753372
canada,1982,0.2245,0.0701,0.7053999999999999,68634,167098,813673,11.8,745039
canada,1983,0.2214,0.0739,0.7047,67558,166932,857780,12.600000000000001,790222
canada,1984,0.2217,0.0773,0.701,67662,166055,897245,13.200000000000001,829583
canada,1985,0.2196,0.0766,0.7038,66932,166719,889120,13.200000000000001,822188
canada,1986,0.2111,0.0781,0.7107999999999999,63980,168377,906531,14.100000000000001,842551
canada,1987,0.2107,0.0806,0.7087,63841,167879,935549,14.600000000000001,871708
canada,1988,0.2093,0.0887,0.702,63355,166292,1029569,16.2,966214
canada,1989,0.2036,0.0948,0.7016,61375,166197,1100373,17.900000000000002,1038998
canada,1990,0.1986,0.0927,0.7087,59639,167879,1075998,18.0,1016359
canada,1991,0.1919,0.0915,0.7166,57312,169751,1062069,18.5,1004757
canada,1992,0.1899,0.0919,0.7182,56617,170130,1066712,18.8,1010095
canada,1993,0.1833,0.0957,0.721,54325,170793,1110820,20.400000000000002,1056495
canada,1994,0.1821,0.0961,0.7218,53908,170982,1115463,20.6,1061555
canada,1995,0.1771,0.0988,0.7241,52171,171527,1146803,21.900000000000002,1094632
canada,1996,0.1752,0.1039,0.7209,51511,170769,1206000,23.400000000000002,1154489
canada,1997,0.1729,0.1113,0.7158,50712,169561,1291894,25.400000000000002,1241182
canada,1998,0.1721,0.1127,0.7152,50435,169419,1308144,25.900000000000002,1257709
canada,1999,0.1738,0.1183,0.7079,51025,167690,1373145,26.900000000000002,1322120
canada,2000,0.1702,0.1269,0.7029,49775,166505,1472968,29.5,1423193
canada,2001,0.1737,0.1271,0.6992,50990,165629,1475290,28.900000000000002,1424300
canada,2002,0.1724,0.1279,0.6997,50539,165747,1484576,29.3,1434037
canada,2003,0.1713,0.1306,0.6980999999999999,50157,165368,1515915,30.200000000000003,1465758
canada,2004,0.1701,0.1359,0.694,49740,164397,1577434,31.700000000000003,1527694
canada,2005,0.1695,0.1402,0.6903,49532,163521,1627346,32.800000000000004,1577814
canada,2006,0.1675,0.1421,0.6904,48837,163544,1649400,33.7,1600563
canada,2007,0.1675,0.1421,0.6904,48837,163544,1649400,33.7,1600563
canada,2008,0.1703,0.1347,0.695,49809,164634,1563505,31.3,1513696
canada,2009,0.1723,0.1186,0.7091,50504,167974,1376628,27.200000000000003,1326124
canada,2010,0.1705,0.1235,0.7060000000000001,49879,167240,1433503,28.700000000000003,1383624
canada,2011,0.1707,0.1228,0.7065,49948,167358,1425378,28.5,1375430
canada,2012,0.1721,0.1162,0.7117,50435,168590,1348770,26.700000000000003,1298335
canada,2013,0.1716,0.1161,0.7123,50261,168732,1347609,26.8,1297348
canada,2014,0.1735,0.1144,0.7121,50921,168685,1327877,26.0,1276956
canada,2015,0.1734,0.1149,0.7117,50886,168590,1333681,26.200000000000003,1282795
canada,2016,0.178,0.099,0.7230000000000001,52484,171267,1149124,21.8,1096640
canada,2017,0.1762,0.1053,0.7185,51859,170201,1222250,23.5,1170391
canada,2018,0.1785,0.1053,0.7162000000000001,52657,169656,1222250,23.200000000000003,1169593
canada,2019,0.1791,0.1039,0.717,52866,169845,1206000,22.8,1153134
canada,2020,0.1691,0.1059,0.725,49393,171740,1229215,24.8,1179822
canada,2021,0.1743,0.1162,0.7095,51199,168069,1348770,26.3,1297571
canada,2022,0.1743,0.1162,0.7095,51199,168069,1348770,26.3,1297571
canada,2023,0.1743,0.1162,0.7095,51199,168069,1348770,26.3,1297571
china,1820,0.187,0.16,0.653,55610,154685,1857171,33.300000000000004,1801561
china,1850,0.1827,0.1718,0.6455000000000001,54116,152908,1994137,36.800000000000004,1940021
china,1880,0.1731,0.1719,0.655,50782,155159,1995298,39.2,1944516
china,1900,0.1721,0.1739,0.654,50435,154922,2018512,40.0,1968077
china,1910,0.1349,0.2417,0.6234,37514,147673,2805489,74.7,2767975
china,1920,0.1558,0.2178,0.6264000000000001,44773,148384,2528074,56.400000000000006,2483301
china,1930,0.1637,0.1984,0.6378999999999999,47517,151108,2302892,48.400000000000006,2255375
china,1940,0.1791,0.1817,0.6392,52866,151416,2109050,39.800000000000004,2056184
china,1950,0.254,0.05,0.696,78880,164871,580365,7.300000000000001,501485
china,1960,0.254,0.05,0.696,78880,164871,580365,7.300000000000001,501485
china,1970,0.254,0.05,0.696,78880,164871,580365,7.300000000000001,501485
china,1978,0.2517,0.065,0.6833,78082,161862,754475,9.600000000000001,676393
china,1979,0.251,0.0652,0.6838,77838,161981,756797,9.700000000000001,678959
china,1980,0.2498,0.0657,0.6845,77422,162147,762600,9.8,685178
china,1981,0.2471,0.0686,0.6843,76484,162099,796262,10.4,719778
china,1982,0.2419,0.0709,0.6872,74678,162786,822958,11.0,748280
china,1983,0.2445,0.0727,0.6828000000000001,75581,161744,843852,11.100000000000001,768271
china,1984,0.2418,0.0761,0.6820999999999999,74643,161578,883317,11.8,808674
china,1985,0.2384,0.0817,0.6799,73462,161057,948318,12.9,874856
china,1986,0.2252,0.0811,0.6937,68877,164326,941353,13.600000000000001,872476
china,1987,0.2207,0.08,0.6993,67314,165653,928585,13.700000000000001,861271
china,1988,0.2188,0.0813,0.6999,66655,165795,943675,14.100000000000001,877020
china,1989,0.2126,0.0833,0.7041,64501,166790,966889,14.9,902388
china,1990,0.2146,0.0821,0.7032999999999999,65196,166600,952960,14.600000000000001,887764
china,1991,0.2027,0.0842,0.7131,61063,168922,977336,16.0,916273
china,1992,0.1939,0.0885,0.7176,58006,169988,1027247,17.7,969241
china,1993,0.1849,0.0929,0.7222,54880,171077,1078320,19.6,1023440
china,1994,0.1811,0.0954,0.7234999999999999,53560,171385,1107338,20.6,1053778
china,1995,0.1849,0.0938,0.7213,54880,170864,1088766,19.8,1033886
china,1996,0.1906,0.0965,0.7129,56860,168874,1120106,19.6,1063246
china,1997,0.1909,0.0965,0.7126,56964,168803,1120106,19.6,1063142
china,1998,0.1915,0.0994,0.7091,57173,167974,1153767,20.1,1096594
china,1999,0.185,0.1002,0.7148000000000001,54915,169324,1163053,21.1,1108138
china,2000,0.1737,0.1046,0.7217,50990,170959,1214125,23.8,1163135
china,2001,0.1681,0.1096,0.7222999999999999,49045,171101,1272162,25.900000000000002,1223117
china,2002,0.1557,0.1265,0.7178,44738,170035,1468325,32.800000000000004,1423587
china,2003,0.1515,0.1323,0.7162000000000001,43280,169656,1535648,35.4,1492368
china,2004,0.1515,0.1393,0.7092,43280,167998,1616899,37.300000000000004,1573619
china,2005,0.1442,0.143,0.7128,40744,168850,1659846,40.7,1619102
china,2006,0.1441,0.1487,0.7071999999999999,40709,167524,1726008,42.300000000000004,1685299
china,2007,0.1425,0.1538,0.7037000000000001,40154,166695,1785205,44.400000000000006,1745051
china,2008,0.1421,0.1529,0.705,40015,167003,1774759,44.300000000000004,1734744
china,2009,0.1414,0.1552,0.7034,39772,166624,1801456,45.2,1761684
china,2010,0.1383,0.152,0.7097,38695,168116,1764312,45.5,1725617
china,2011,0.1409,0.1467,0.7123999999999999,39598,168756,1702793,43.0,1663195
china,2012,0.1454,0.1383,0.7163,41161,169680,1605292,39.0,1564131
china,2013,0.1403,0.1389,0.7208,39390,170746,1612256,40.900000000000006,1572866
china,2014,0.1438,0.1374,0.7188,40605,170272,1594845,39.2,1554240
china,2015,0.1436,0.14,0.7163999999999999,40536,169703,1625024,40.0,1584488
china,2016,0.1411,0.1405,0.7183999999999999,39668,170177,1630828,41.1,1591160
china,2017,0.1386,0.1516,0.7098,38799,168140,1759669,45.300000000000004,1720870
china,2018,0.1393,0.1485,0.7122,39042,168708,1723686,44.1,1684644
china,2019,0.1398,0.1466,0.7135999999999999,39216,169040,1701633,43.300000000000004,1662417
china,2020,0.1377,0.1556,0.7067000000000001,38487,167405,1806098,46.900000000000006,1767611
china,2021,0.1374,0.1572,0.7054,38382,167098,1824670,47.5,1786288
china,2022,0.1351,0.1576,0.7073,37584,167548,1829313,48.6,1791729
china,2023,0.1351,0.1576,0.7073,37584,167548,1829313,48.6,1791729
germany,1820,0.1815,0.1769,0.6416,53699,151984,2053334,38.2,1999635
germany,1850,0.178,0.1808,0.6412,52484,151890,2098603,39.900000000000006,2046119
germany,1880,0.1836,0.1745,0.6419,54429,152055,2025477,37.2,1971048
germany,1900,0.1678,0.2244,0.6078000000000001,48941,143978,2604682,53.2,2555741
germany,1910,0.1759,0.214,0.6101000000000001,51754,144522,2483966,47.900000000000006,2432212
germany,1920,0.1724,0.2185,0.6091,50539,144286,2536199,50.1,2485660
germany,1930,0.2229,0.1249,0.6522,68079,154495,1449754,21.200000000000003,1381675
germany,1940,0.1917,0.1574,0.6509,57242,154187,1826992,31.900000000000002,1769750
germany,1950,0.2205,0.1078,0.6717,67245,159115,1251269,18.6,1184024
germany,1960,0.2289,0.1143,0.6568,70163,155585,1326716,18.900000000000002,1256553
germany,1970,0.2409,0.1022,0.6569,74330,155609,1186268,15.9,1111938
germany,1980,0.2347,0.0968,0.6685,72177,158357,1123588,15.5,1051411
germany,1981,0.2353,0.0928,0.6718999999999999,72385,159162,1077159,14.8,1004774
germany,1982,0.2393,0.0905,0.6701999999999999,73775,158759,1050462,14.200000000000001,976687
germany,1983,0.2357,0.0928,0.6715,72524,159067,1077159,14.8,1004635
germany,1984,0.2384,0.0927,0.6689,73462,158451,1075998,14.600000000000001,1002536
germany,1985,0.238,0.0942,0.6678,73323,158191,1093409,14.9,1020086
germany,1986,0.2356,0.0984,0.6659999999999999,72490,157764,1142160,15.700000000000001,1069670
germany,1987,0.2316,0.1029,0.6655,71100,157646,1194393,16.7,1123293
germany,1988,0.2255,0.1115,0.6629999999999999,68982,157054,1294216,18.7,1225234
germany,1989,0.2215,0.1164,0.6620999999999999,67592,156840,1351092,19.900000000000002,1283500
germany,1990,0.2186,0.1131,0.6683,66585,158309,1312787,19.700000000000003,1246202
germany,1991,0.2236,0.102,0.6744,68322,159754,1183946,17.3,1115624
germany,1992,0.2265,0.0952,0.6783,69329,160678,1105016,15.9,1035687
germany,1993,0.2293,0.0909,0.6798,70301,161033,1055105,15.0,984804
germany,1994,0.2325,0.088,0.6795,71413,160962,1021444,14.3,950031
germany,1995,0.2332,0.0867,0.6801,71656,161104,1006354,14.0,934698
germany,1996,0.228,0.0941,0.6779000000000001,69850,160583,1092248,15.600000000000001,1022398
germany,1997,0.2231,0.1005,0.6764,68148,160228,1166535,17.1,1098387
germany,1998,0.2177,0.1081,0.6742,66273,159707,1254751,18.900000000000002,1188478
germany,1999,0.2209,0.1044,0.6747,67384,159825,1211804,17.900000000000002,1144420
germany,2000,0.2178,0.103,0.6792,66307,160891,1195553,18.0,1129246
germany,2001,0.2172,0.1011,0.6817,66099,161483,1173500,17.7,1107401
germany,2002,0.2139,0.0993,0.6868000000000001,64953,162691,1152606,17.7,1087653
germany,2003,0.2187,0.0931,0.6882,66620,163023,1080641,16.2,1014021
germany,2004,0.2122,0.1042,0.6836,64362,161933,1209482,18.7,1145120
germany,2005,0.2017,0.1187,0.6796,60715,160986,1377788,22.6,1317073
germany,2006,0.2004,0.1251,0.6745,60264,159778,1452075,24.0,1391811
germany,2007,0.196,0.1338,0.6701999999999999,58736,158759,1553059,26.400000000000002,1494323
germany,2008,0.1948,0.132,0.6732,58319,159470,1532166,26.200000000000003,1473847
germany,2009,0.195,0.1268,0.6781999999999999,58388,160654,1471808,25.200000000000003,1413420
germany,2010,0.1968,0.1258,0.6774,59013,160465,1460200,24.700000000000003,1401187
germany,2011,0.1945,0.1252,0.6803,58215,161152,1453236,24.900000000000002,1395021
germany,2012,0.1931,0.1233,0.6836,57728,161933,1431182,24.700000000000003,1373454
germany,2013,0.1862,0.128,0.6858,55332,162455,1485736,26.8,1430404
germany,2014,0.1855,0.1298,0.6847,55089,162194,1506630,27.3,1451541
germany,2015,0.1864,0.1298,0.6838,55401,161981,1506630,27.1,1451229
germany,2016,0.1881,0.1296,0.6823000000000001,55992,161626,1504308,26.8,1448316
germany,2017,0.1896,0.1291,0.6813,56513,161389,1498504,26.5,1441991
germany,2018,0.1923,0.1274,0.6803,57450,161152,1478772,25.700000000000003,1421322
germany,2019,0.1914,0.1284,0.6802,57138,161128,1490379,26.0,1433241
germany,2020,0.1919,0.1278,0.6803,57312,161152,1483415,25.8,1426103
germany,2021,0.1919,0.1278,0.6803,57312,161152,1483415,25.8,1426103
germany,2022,0.1919,0.1278,0.6803,57312,161152,1483415,25.8,1426103
germany,2023,0.1919,0.1278,0.6803,57312,161152,1483415,25.8,1426103
italy,1820,0.1596,0.2202,0.6202000000000001,46093,146915,2555931,55.400000000000006,2509838
italy,1850,0.1572,0.2255,0.6173,45259,146228,2617450,57.800000000000004,2572191
italy,1880,0.1563,0.2225,0.6212,44947,147152,2582628,57.400000000000006,2537681
italy,1900,0.1438,0.2789,0.5773,40605,136753,3237281,79.7,3196676
italy,1910,0.1544,0.2675,0.5781,44287,136942,3104958,70.10000000000001,3060671
italy,1920,0.1854,0.2131,0.6014999999999999,55054,142485,2473519,44.900000000000006,2418465
italy,1930,0.2086,0.1631,0.6283,63112,148834,1893153,29.900000000000002,1830041
italy,1940,0.2045,0.1479,0.6476,61688,153406,1716722,27.8,1655034
italy,1950,0.2281,0.1071,0.6648000000000001,69885,157480,1243143,17.7,1173258
italy,1960,0.2274,0.1012,0.6714,69642,159043,1174660,16.8,1105018
italy,1970,0.2708,0.053,0.6761999999999999,84715,160181,615187,7.2,530472
italy,1980,0.2089,0.0624,0.7287,63216,172617,724296,11.4,661080
italy,1981,0.2137,0.0573,0.729,64883,172688,665099,10.200000000000001,600216
italy,1982,0.2144,0.0563,0.7293,65126,172759,653492,10.0,588366
italy,1983,0.2156,0.0559,0.7285,65543,172570,648849,9.8,583306
italy,1984,0.2133,0.058,0.7286999999999999,64744,172617,673224,10.3,608480
italy,1985,0.2123,0.0617,0.726,64397,171977,716171,11.100000000000001,651774
italy,1986,0.21,0.0695,0.7205,63598,170674,806708,12.600000000000001,743110
italy,1987,0.2057,0.0709,0.7234,62105,171361,822958,13.200000000000001,760853
italy,1988,0.1992,0.0749,0.7259,59847,171954,869388,14.5,809541
italy,1989,0.1973,0.0765,0.7262,59187,172025,887959,15.0,828772
italy,1990,0.1926,0.076,0.7314,57555,173257,882156,15.3,824601
italy,1991,0.1966,0.0767,0.7267,58944,172143,890281,15.100000000000001,831337
italy,1992,0.1924,0.0768,0.7308,57485,173114,891442,15.5,833957
italy,1993,0.1879,0.0794,0.7326999999999999,55922,173564,921621,16.400000000000002,865699
italy,1994,0.1829,0.0822,0.7348999999999999,54186,174086,954121,17.6,899935
italy,1995,0.1807,0.0882,0.7311,53422,173185,1023765,19.1,970343
italy,1996,0.1773,0.0904,0.7323,52241,173470,1049301,20.0,997060
italy,1997,0.1786,0.0919,0.7295,52692,172806,1066712,20.200000000000003,1014020
italy,1998,0.1711,0.0959,0.733,50087,173636,1113141,22.200000000000003,1063054
italy,1999,0.1729,0.0935,0.7336,50712,173778,1085284,21.400000000000002,1034572
italy,2000,0.1707,0.0992,0.7301000000000001,49948,172949,1151446,23.0,1101498
italy,2001,0.1692,0.1035,0.7273,49427,172285,1201357,24.3,1151930
italy,2002,0.1709,0.0997,0.7294,50018,172783,1157249,23.1,1107231
italy,2003,0.1699,0.1006,0.7295,49670,172806,1167696,23.5,1118026
italy,2004,0.1698,0.0991,0.7311000000000001,49636,173185,1150285,23.1,1100649
italy,2005,0.1751,0.0983,0.7265999999999999,51477,172119,1140999,22.1,1089522
italy,2006,0.1741,0.0987,0.7272,51129,172262,1145642,22.400000000000002,1094513
italy,2007,0.1736,0.0962,0.7302000000000001,50956,172972,1116624,21.900000000000002,1065668
italy,2008,0.1794,0.0867,0.7339,52970,173849,1006354,18.900000000000002,953384
italy,2009,0.1789,0.0889,0.7322,52796,173446,1031890,19.5,979094
italy,2010,0.1754,0.0939,0.7307,51581,173091,1089927,21.1,1038346
italy,2011,0.1728,0.1062,0.7210000000000001,50678,170793,1232697,24.3,1182019
italy,2012,0.1714,0.1139,0.7147,50191,169301,1322073,26.3,1271882
italy,2013,0.1678,0.1105,0.7217,48941,170959,1282608,26.200000000000003,1233667
italy,2014,0.1679,0.1123,0.7198,48976,170509,1303502,26.6,1254526
italy,2015,0.1695,0.1056,0.7249,49532,171717,1225732,24.700000000000003,1176200
italy,2016,0.167,0.123,0.71,48663,168187,1427700,29.3,1379037
italy,2017,0.1657,0.1271,0.7072,48212,167524,1475290,30.6,1427078
italy,2018,0.1641,0.1259,0.71,47656,168187,1461361,30.6,1413705
italy,2019,0.1649,0.1243,0.7108000000000001,47934,168377,1442789,30.0,1394855
italy,2020,0.166,0.1228,0.7111999999999999,48316,168471,1425378,29.5,1377062
italy,2021,0.166,0.1228,0.7111999999999999,48316,168471,1425378,29.5,1377062
italy,2022,0.166,0.1228,0.7111999999999999,48316,168471,1425378,29.5,1377062
italy,2023,0.166,0.1228,0.7111999999999999,48316,168471,1425378,29.5,1377062
japan,1820,0.1273,0.2159,0.6568,34874,155585,2506020,71.8,2471146
japan,1850,0.1252,0.2207,0.6541,34145,154945,2561735,75.0,2527590
japan,1880,0.121,0.2183,0.6607000000000001,32686,156509,2533877,77.5,2501191
japan,1900,0.1148,0.2425,0.6427,30533,152245,2814775,92.10000000000001,2784242
japan,1910,0.111,0.2599,0.6291,29213,149023,3016742,103.2,2987529
japan,1920,0.1454,0.2178,0.6368,41161,150847,2528074,61.400000000000006,2486913
japan,1930,0.1528,0.1984,0.6488,43731,153690,2302892,52.6,2259161
japan,1940,0.1672,0.1817,0.6511,48733,154235,2109050,43.2,2060317
japan,1950,0.2173,0.1054,0.6773,66134,160441,1223411,18.400000000000002,1157277
japan,1960,0.2106,0.1109,0.6785,63807,160725,1287251,20.1,1223444
japan,1970,0.2065,0.1157,0.6778,62382,160560,1342966,21.5,1280584
japan,1980,0.2902,0.0478,0.662,91453,156817,554829,6.0,463376
japan,1981,0.2937,0.0461,0.6601999999999999,92669,156390,535097,5.7,442428
japan,1982,0.2953,0.0459,0.6587999999999999,93225,156059,532775,5.7,439550
japan,1983,0.2928,0.0457,0.6615,92357,156698,530454,5.7,438097
japan,1984,0.2904,0.0466,0.663,91523,157054,540901,5.9,449378
japan,1985,0.2848,0.048,0.6672,89578,158049,557151,6.2,467573
japan,1986,0.2817,0.0507,0.6676,88501,158143,588491,6.6000000000000005,499990
japan,1987,0.276,0.0575,0.6665,86521,157883,667420,7.7,580899
japan,1988,0.2726,0.0591,0.6682999999999999,85341,158309,685992,8.0,600651
japan,1989,0.2718,0.0641,0.6640999999999999,85063,157314,744029,8.700000000000001,658966
japan,1990,0.2731,0.068,0.6588999999999999,85514,156082,789297,9.200000000000001,703783
japan,1991,0.2789,0.0631,0.6579999999999999,87529,155869,732421,8.3,644892
japan,1992,0.2918,0.0448,0.6634,92009,157148,520007,5.6000000000000005,427998
japan,1993,0.2886,0.0458,0.6656,90898,157670,531615,5.800000000000001,440717
japan,1994,0.2866,0.0452,0.6681999999999999,90203,158285,524650,5.800000000000001,434447
japan,1995,0.2803,0.0473,0.6724,88015,159280,549026,6.2,461011
japan,1996,0.2735,0.0507,0.6758,85653,160086,588491,6.800000000000001,502838
japan,1997,0.2734,0.0479,0.6787,85618,160773,555990,6.4,470372
japan,1998,0.2726,0.0475,0.6799,85341,161057,551347,6.4,466006
japan,1999,0.27,0.049,0.6809999999999999,84438,161318,568758,6.7,484320
japan,2000,0.2636,0.0525,0.6839,82215,162005,609384,7.4,527169
japan,2001,0.2589,0.0542,0.6869,80582,162715,629116,7.800000000000001,548534
japan,2002,0.2536,0.056,0.6903999999999999,78741,163544,650009,8.200000000000001,571268
japan,2003,0.2503,0.0585,0.6912,77595,163734,679028,8.700000000000001,601433
japan,2004,0.2459,0.0628,0.6913,76067,163757,728939,9.5,652872
japan,2005,0.2463,0.065,0.6887000000000001,76206,163142,754475,9.9,678269
japan,2006,0.247,0.0658,0.6872,76449,162786,763761,9.9,687312
japan,2007,0.2462,0.066,0.6878,76171,162928,766083,10.0,689912
japan,2008,0.2512,0.062,0.6868,77908,162691,719653,9.200000000000001,641745
japan,2009,0.2645,0.058,0.6775,82527,160488,673224,8.1,590697
japan,2010,0.2647,0.061,0.6743000000000001,82597,159730,708046,8.5,625449
japan,2011,0.2678,0.06,0.6721999999999999,83673,159233,696439,8.3,612766
japan,2012,0.268,0.0603,0.6717,83743,159115,699921,8.3,616178
japan,2013,0.2671,0.0612,0.6717,83430,159115,710367,8.5,626937
japan,2014,0.2674,0.0611,0.6715,83535,159067,709207,8.4,625672
japan,2015,0.2665,0.0609,0.6726000000000001,83222,159328,706885,8.4,623663
japan,2016,0.2655,0.0607,0.6738,82875,159612,704564,8.5,621689
japan,2017,0.2646,0.0605,0.6749,82562,159873,702242,8.5,619680
japan,2018,0.2636,0.0603,0.6760999999999999,82215,160157,699921,8.5,617706
japan,2019,0.2626,0.0601,0.6773,81867,160441,697599,8.5,615732
japan,2020,0.2626,0.0601,0.6773,81867,160441,697599,8.5,615732
japan,2021,0.2626,0.0601,0.6773,81867,160441,697599,8.5,615732
japan,2022,0.2626,0.0601,0.6773,81867,160441,697599,8.5,615732
japan,2023,0.2626,0.0601,0.6773,81867,160441,697599,8.5,615732
new_zealand,1820,0.1185,0.1443,0.7372000000000001,31818,174630,1674936,52.6,1643118
new_zealand,1850,0.1165,0.1475,0.736,31123,174346,1712079,55.0,1680956
new_zealand,1880,0.1175,0.1459,0.7365999999999999,31471,174488,1693507,53.800000000000004,1662036
new_zealand,1900,0.1073,0.1621,0.7305999999999999,27928,173067,1881546,67.3,1853618
new_zealand,1910,0.1073,0.1621,0.7305999999999999,27928,173067,1881546,67.3,1853618
new_zealand,1920,0.0979,0.1884,0.7137,24663,169064,2186819,88.60000000000001,2162156
new_zealand,1921,0.0989,0.2068,0.6943,25010,164468,2400393,95.9,2375383
new_zealand,1922,0.1114,0.193,0.6956,29352,164776,2240212,76.3,2210860
new_zealand,1923,0.1046,0.2008,0.6946,26990,164539,2330749,86.30000000000001,2303759
new_zealand,1924,0.1053,0.1999,0.6948000000000001,27233,164587,2320303,85.2,2293070
new_zealand,1925,0.0993,0.2026,0.6980999999999999,25149,165368,2351642,93.5,2326493
new_zealand,1926,0.0952,0.1975,0.7073,23725,167548,2292445,96.60000000000001,2268720
new_zealand,1927,0.095,0.1942,0.7108,23656,168377,2254141,95.2,2230485
new_zealand,1928,0.0952,0.2094,0.6954,23725,164729,2430572,102.4,2406847
new_zealand,1929,0.0913,0.1999,0.7088,22371,167903,2320303,103.7,2297932
new_zealand,1930,0.082,0.1912,0.7268,19141,172167,2219319,115.9,2200178
new_zealand,1931,0.0823,0.1931,0.7245999999999999,19245,171646,2241373,116.4,2222128
new_zealand,1932,0.0826,0.1952,0.7222,19349,171077,2265748,117.0,2246399
new_zealand,1933,0.0831,0.1969,0.7200000000000001,19523,170556,2285481,117.0,2265958
new_zealand,1934,0.0833,0.1891,0.7275999999999999,19592,172356,2194944,112.0,2175352
new_zealand,1935,0.093,0.1889,0.7181,22961,170106,2192622,95.4,2169661
new_zealand,1936,0.1012,0.1955,0.7033,25809,166600,2269231,87.9,2243422
new_zealand,1937,0.1189,0.1555,0.7256,31957,171883,1804938,56.400000000000006,1772981
new_zealand,1938,0.1329,0.1386,0.7284999999999999,36819,172570,1608774,43.6,1571955
new_zealand,1939,0.1212,0.1475,0.7313000000000001,32756,173233,1712079,52.2,1679323
new_zealand,1940,0.1266,0.1398,0.7336,34631,173778,1622703,46.800000000000004,1588072
new_zealand,1941,0.1309,0.1381,0.731,36125,173162,1602970,44.300000000000004,1566845
new_zealand,1942,0.1352,0.1364,0.7284,37618,172546,1583238,42.0,1545620
new_zealand,1943,0.1394,0.1347,0.7259,39077,171954,1563505,40.0,1524428
new_zealand,1944,0.1437,0.133,0.7233,40571,171338,1543773,38.0,1503202
new_zealand,1945,0.1481,0.1313,0.7206,42099,170698,1524041,36.2,1481942
new_zealand,1946,0.1375,0.1419,0.7205999999999999,38417,170698,1647078,42.800000000000004,1608661
new_zealand,1947,0.1295,0.1452,0.7253000000000001,35639,171812,1685382,47.2,1649743
new_zealand,1948,0.1266,0.1457,0.7277,34631,172380,1691186,48.800000000000004,1656555
new_zealand,1949,0.1226,0.1507,0.7266999999999999,33242,172143,1749223,52.6,1715981
new_zealand,1950,0.117,0.1744,0.7086,31297,167856,2024316,64.60000000000001,1993019
new_zealand,1951,0.1247,0.1478,0.7275,33971,172333,1715561,50.5,1681590
new_zealand,1952,0.1199,0.1485,0.7316,32304,173304,1723686,53.300000000000004,1691382
new_zealand,1953,0.1199,0.1485,0.7316,32304,173304,1723686,53.300000000000004,1691382
new_zealand,1954,0.1217,0.1437,0.7346,32929,174015,1667971,50.6,1635042
new_zealand,1955,0.1258,0.1324,0.7418,34353,175720,1536809,44.7,1502456
new_zealand,1956,0.1214,0.1345,0.7441,32825,176265,1561184,47.5,1528359
new_zealand,1957,0.126,0.1314,0.7426,34423,175910,1525201,44.300000000000004,1490778
new_zealand,1958,0.1334,0.1108,0.7558,36993,179036,1286091,34.7,1249098
new_zealand,1959,0.1304,0.1158,0.7538,35951,178563,1344127,37.300000000000004,1308176
new_zealand,1960,0.1323,0.1137,0.754,36611,178610,1319752,36.0,1283141
new_zealand,1961,0.1323,0.1125,0.7552,36611,178894,1305823,35.6,1269212
new_zealand,1962,0.1325,0.1111,0.7564,36681,179179,1289573,35.1,1252892
new_zealand,1963,0.1323,0.1116,0.7561,36611,179108,1295376,35.300000000000004,1258765
new_zealand,1964,0.1301,0.1137,0.7562,35847,179131,1319752,36.800000000000004,1283905
new_zealand,1965,0.1355,0.1036,0.7608999999999999,37723,180245,1202518,31.8,1164795
new_zealand,1966,0.1368,0.1012,0.762,38174,180505,1174660,30.700000000000003,1136486
new_zealand,1967,0.1356,0.1016,0.7627999999999999,37757,180695,1179303,31.200000000000003,1141546
new_zealand,1968,0.135,0.1034,0.7615999999999999,37549,180410,1200196,31.900000000000002,1162647
new_zealand,1969,0.1355,0.1034,0.7610999999999999,37723,180292,1200196,31.8,1162473
new_zealand,1970,0.1364,0.1025,0.7611,38035,180292,1189750,31.200000000000003,1151715
new_zealand,1971,0.1363,0.1002,0.7635000000000001,38000,180860,1163053,30.6,1125053
new_zealand,1972,0.1348,0.1106,0.7545999999999999,37479,178752,1283769,34.2,1246290
new_zealand,1973,0.1328,0.1162,0.751,36785,177899,1348770,36.6,1311985
new_zealand,1974,0.1358,0.1082,0.756,37827,179084,1255912,33.2,1218085
new_zealand,1975,0.1472,0.0902,0.7626,41786,180647,1046980,25.0,1005194
new_zealand,1976,0.1421,0.1077,0.7502,40015,177710,1250108,31.200000000000003,1210093
new_zealand,1977,0.1511,0.0871,0.7618,43141,180458,1010997,23.400000000000002,967856
new_zealand,1978,0.151,0.0848,0.7642,43106,181026,984300,22.8,941194
new_zealand,1979,0.1544,0.0808,0.7648,44287,181168,937871,21.1,893584
new_zealand,1980,0.1512,0.0772,0.7716,43175,182779,896085,20.700000000000003,852910
new_zealand,1981,0.1514,0.0764,0.7722,43245,182921,886799,20.5,843554
new_zealand,1982,0.1493,0.0773,0.7734,42516,183206,897245,21.1,854729
new_zealand,1983,0.1449,0.0863,0.7687999999999999,40987,182116,1001711,24.400000000000002,960724
new_zealand,1984,0.1491,0.0853,0.7656,42446,181358,990104,23.3,947658
new_zealand,1985,0.1544,0.0812,0.7644000000000001,44287,181074,942514,21.200000000000003,898227
new_zealand,1986,0.1588,0.0722,0.7689999999999999,45815,182163,838048,18.2,792233
new_zealand,1987,0.1617,0.0788,0.7595000000000001,46822,179913,914656,19.5,867834
new_zealand,1988,0.1611,0.0817,0.7572,46614,179368,948318,20.3,901704
new_zealand,1989,0.1524,0.0992,0.7484000000000001,43592,177284,1151446,26.400000000000002,1107854
new_zealand,1990,0.1418,0.1195,0.7387,39911,174986,1387074,34.7,1347163
new_zealand,1991,0.1442,0.1057,0.7501,40744,177686,1226893,30.1,1186149
new_zealand,1992,0.139,0.1128,0.7482,38938,177236,1309305,33.6,1270367
new_zealand,1993,0.1369,0.119,0.7441,38209,176265,1381271,36.1,1343062
new_zealand,1994,0.1378,0.1232,0.739,38521,175057,1430021,37.1,1391500
new_zealand,1995,0.1388,0.1243,0.7369,38869,174559,1442789,37.1,1403920
new_zealand,1996,0.1432,0.1183,0.7385,40397,174938,1373145,33.9,1332748
new_zealand,1997,0.1395,0.1262,0.7343,39112,173943,1464843,37.4,1425731
new_zealand,1998,0.1323,0.1381,0.7296,36611,172830,1602970,43.7,1566359
new_zealand,1999,0.1625,0.1529,0.6846,47100,162170,1774759,37.6,1727659
new_zealand,2000,0.1808,0.1161,0.7031000000000001,53456,166553,1347609,25.200000000000003,1294153
new_zealand,2001,0.1761,0.1237,0.7001999999999999,51824,165866,1435825,27.700000000000003,1384001
new_zealand,2002,0.1943,0.1248,0.6809,58145,161294,1448593,24.900000000000002,1390448
new_zealand,2003,0.1981,0.1286,0.6733,59465,159494,1492701,25.1,1433236
new_zealand,2004,0.2039,0.2111,0.585,61479,138577,2450305,39.800000000000004,2388826
new_zealand,2005,0.2155,0.161,0.6234999999999999,65508,147697,1868778,28.5,1803270
new_zealand,2006,0.2412,0.1005,0.6583,74435,155940,1166535,15.600000000000001,1092100
new_zealand,2007,0.2346,0.1048,0.6606,72142,156485,1216447,16.8,1144305
new_zealand,2008,0.2319,0.1629,0.6052,71205,143362,1890832,26.5,1819627
new_zealand,2009,0.2198,0.1874,0.5928,67002,140424,2175211,32.4,2108209
new_zealand,2010,0.1967,0.2239,0.5794,58979,137250,2598878,44.0,2539899
new_zealand,2011,0.2201,0.1972,0.5827,67106,138032,2288963,34.1,2221857
new_zealand,2012,0.2292,0.1364,0.6344000000000001,70267,150279,1583238,22.5,1512971
new_zealand,2013,0.2327,0.1215,0.6458,71482,152979,1410289,19.700000000000003,1338807
new_zealand,2014,0.2325,0.1181,0.6494,71413,153832,1370824,19.1,1299411
new_zealand,2015,0.2322,0.1147,0.6531,71309,154708,1331359,18.6,1260050
new_zealand,2016,0.2319,0.1113,0.6568,71205,155585,1291894,18.1,1220689
new_zealand,2017,0.2386,0.1154,0.646,73532,153027,1339484,18.2,1265952
new_zealand,2018,0.2443,0.1069,0.6488,75511,153690,1240822,16.400000000000002,1165311
new_zealand,2019,0.2193,0.1191,0.6616,66828,156722,1382431,20.6,1315603
new_zealand,2020,0.1937,0.13,0.6763,57937,160204,1508951,26.0,1451014
new_zealand,2021,0.1854,0.1677,0.6469,55054,153240,1946547,35.300000000000004,1891493
new_zealand,2022,0.2044,0.1208,0.6748,61653,159849,1402164,22.700000000000003,1340511
new_zealand,2023,0.2044,0.1208,0.6748,61653,159849,1402164,22.700000000000003,1340511
norway,1980,0.253,0.0747,0.6723,78533,159257,867066,11.0,788533
norway,1981,0.2547,0.0736,0.6717,79123,159115,854298,10.700000000000001,775175
norway,1982,0.2596,0.0712,0.6692,80825,158522,826441,10.200000000000001,745616
norway,1983,0.2633,0.0698,0.6669,82110,157977,810190,9.8,728080
norway,1984,0.2634,0.0776,0.659,82145,156106,900728,10.9,818583
norway,1985,0.263,0.0796,0.6574,82006,155727,923942,11.200000000000001,841936
norway,1986,0.2766,0.0576,0.6658,86730,157717,668581,7.7,581851
norway,1987,0.2782,0.0555,0.6663,87286,157835,644206,7.300000000000001,556920
norway,1988,0.2838,0.0497,0.6665000000000001,89231,157883,576883,6.4,487652
norway,1989,0.2868,0.0566,0.6566000000000001,90273,155538,656974,7.2,566701
norway,1990,0.2843,0.0583,0.6574,89404,155727,676706,7.5,587302
norway,1991,0.2853,0.0598,0.6549,89752,155135,694117,7.7,604365
norway,1992,0.284,0.0686,0.6474,89300,153358,796262,8.9,706962
norway,1993,0.2731,0.0802,0.6466999999999999,85514,153192,930907,10.8,845393
norway,1994,0.2634,0.0849,0.6517,82145,154377,985461,11.9,903316
norway,1995,0.2641,0.0848,0.6511,82388,154235,984300,11.9,901912
norway,1996,0.2553,0.0975,0.6472,79332,153311,1131713,14.200000000000001,1052381
norway,1997,0.2468,0.1053,0.6479,76380,153477,1222250,16.0,1145870
norway,1998,0.2605,0.0887,0.6508,81138,154164,1029569,12.600000000000001,948431
norway,1999,0.2565,0.0986,0.6449,79749,152766,1144481,14.3,1064732
norway,2000,0.2412,0.1261,0.6327,74435,149876,1463683,19.6,1389248
norway,2001,0.2539,0.1069,0.6392,78846,151416,1240822,15.700000000000001,1161976
norway,2002,0.2525,0.1146,0.6329,78359,149923,1330198,16.900000000000002,1251839
norway,2003,0.2482,0.1196,0.6322,76866,149758,1388235,18.0,1311369
norway,2004,0.2435,0.1264,0.6300999999999999,75233,149260,1467165,19.5,1391932
norway,2005,0.2366,0.141,0.6224,72837,147436,1636632,22.400000000000002,1563795
norway,2006,0.2361,0.1323,0.6316,72663,149615,1535648,21.1,1462985
norway,2007,0.2361,0.1321,0.6318,72663,149663,1533326,21.1,1460663
norway,2008,0.2368,0.1399,0.6233,72906,147649,1623864,22.200000000000003,1550958
norway,2009,0.2494,0.1109,0.6396999999999999,77283,151534,1287251,16.6,1209968
norway,2010,0.2409,0.124,0.6351,74330,150445,1439307,19.3,1364977
norway,2011,0.2381,0.1245,0.6374,73358,150989,1445111,19.6,1371753
norway,2012,0.236,0.1263,0.6377,72629,151060,1466004,20.1,1393375
norway,2013,0.2383,0.1205,0.6412,73427,151890,1398682,19.0,1325255
norway,2014,0.2378,0.1169,0.6453,73254,152861,1356895,18.5,1283641
norway,2015,0.2449,0.0996,0.6555,75720,155277,1156089,15.200000000000001,1080369
norway,2016,0.2443,0.0977,0.658,75511,155869,1134035,15.0,1058524
norway,2017,0.2418,0.1025,0.6557,74643,155324,1189750,15.9,1115107
norway,2018,0.2372,0.1113,0.6515000000000001,73045,154329,1291894,17.6,1218849
norway,2019,0.2398,0.0966,0.6636,73948,157196,1121267,15.100000000000001,1047319
norway,2020,0.2423,0.0934,0.6643,74817,157362,1084123,14.4,1009306
norway,2021,0.2423,0.0934,0.6643,74817,157362,1084123,14.4,1009306
norway,2022,0.2423,0.0934,0.6643,74817,157362,1084123,14.4,1009306
norway,2023,0.2423,0.0934,0.6643,74817,157362,1084123,14.4,1009306
russia,1820,0.1763,0.1601,0.6636,51893,157196,1858331,35.800000000000004,1806438
russia,1850,0.1748,0.1637,0.6615,51372,156698,1900118,36.9,1848746
russia,1880,0.1719,0.1619,0.6662000000000001,50365,157812,1879225,37.300000000000004,1828860
russia,1900,0.1674,0.1799,0.6527000000000001,48802,154614,2088156,42.7,2039354
russia,1905,0.1506,0.1835,0.6658999999999999,42967,157741,2129943,49.5,2086976
russia,1910,0.1674,0.1799,0.6527000000000001,48802,154614,2088156,42.7,2039354
russia,1920,0.2936,0.041,0.6654,92634,157622,475900,5.1000000000000005,383266
russia,1928,0.2721,0.0376,0.6903,85167,163521,436435,5.1000000000000005,351268
russia,1930,0.2936,0.041,0.6654,92634,157622,475900,5.1000000000000005,383266
russia,1934,0.2573,0.0441,0.6986,80027,165487,511882,6.300000000000001,431855
russia,1940,0.271,0.042,0.6869999999999999,84785,162739,487507,5.7,402722
russia,1950,0.2519,0.06,0.6880999999999999,78151,162999,696439,8.9,618288
russia,1956,0.2262,0.0562,0.7176,69225,169988,652331,9.4,583106
russia,1959,0.2325,0.047,0.7204999999999999,71413,170674,545544,7.6000000000000005,474131
russia,1960,0.2537,0.05,0.6962999999999999,78776,164942,580365,7.300000000000001,501589
russia,1961,0.2392,0.0461,0.7147,73740,169301,535097,7.2,461357
russia,1964,0.2518,0.0443,0.7039,78116,166742,514204,6.5,436088
russia,1966,0.2693,0.0418,0.6889000000000001,84194,163189,485185,5.7,400991
russia,1968,0.2895,0.039,0.6715,91210,159067,452685,4.9,361475
russia,1970,0.2964,0.048,0.6556,93607,155301,557151,5.9,463544
russia,1972,0.2822,0.0406,0.6772,88675,160417,471257,5.300000000000001,382582
russia,1976,0.2846,0.039,0.6763999999999999,89508,160228,452685,5.0,363177
russia,1980,0.2884,0.0356,0.676,90828,160133,413220,4.5,322392
russia,1981,0.2869,0.0379,0.6752,90307,159944,439917,4.800000000000001,349610
russia,1982,0.2854,0.0401,0.6745,89786,159778,465453,5.1000000000000005,375667
russia,1983,0.2841,0.042,0.6738999999999999,89335,159636,487507,5.4,398172
russia,1984,0.2829,0.0439,0.6732,88918,159470,509561,5.7,420643
russia,1985,0.2818,0.0456,0.6726000000000001,88536,159328,529293,5.9,440757
russia,1986,0.2813,0.0471,0.6716,88362,159091,546704,6.1000000000000005,458342
russia,1987,0.2808,0.0487,0.6705000000000001,88189,158830,565276,6.4,477087
russia,1988,0.2803,0.0501,0.6696,88015,158617,581526,6.6000000000000005,493511
russia,1989,0.2731,0.0562,0.6707,85514,158878,652331,7.6000000000000005,566817
russia,1990,0.2837,0.0745,0.6417999999999999,89196,152032,864745,9.600000000000001,775549
russia,1991,0.2791,0.0852,0.6357,87598,150587,988943,11.200000000000001,901345
russia,1992,0.2167,0.1013,0.682,65925,161554,1175821,17.8,1109896
russia,1993,0.203,0.1111,0.6859,61167,162478,1289573,21.0,1228406
russia,1994,0.1553,0.1208,0.7239,44600,171480,1402164,31.400000000000002,1357564
russia,1995,0.1417,0.1378,0.7204999999999999,39876,170674,1599488,40.1,1559612
russia,1996,0.099,0.1616,0.7394000000000001,25045,175152,1875742,74.8,1850697
russia,1997,0.1262,0.1523,0.7215,34492,170911,1767794,51.2,1733302
russia,1998,0.1456,0.1489,0.7055,41230,167121,1728329,41.900000000000006,1687099
russia,1999,0.1412,0.1845,0.6743,39702,159730,2141550,53.900000000000006,2101848
russia,2000,0.1343,0.2159,0.6498,37306,153927,2506020,67.10000000000001,2468714
russia,2001,0.1327,0.2453,0.622,36750,147341,2847275,77.4,2810525
russia,2002,0.1375,0.2391,0.6234,38417,147673,2775310,72.2,2736893
russia,2003,0.1341,0.2325,0.6334,37236,150042,2698701,72.4,2661465
russia,2004,0.1389,0.2188,0.6423,38903,152150,2539681,65.2,2500778
russia,2005,0.1435,0.2389,0.6176,40501,146299,2772988,68.4,2732487
russia,2006,0.1376,0.247,0.6154,38452,145778,2867007,74.5,2828555
russia,2007,0.1354,0.259,0.6056,37688,143456,3006295,79.7,2968607
russia,2008,0.1311,0.2375,0.6314,36194,149568,2756738,76.10000000000001,2720544
russia,2009,0.1453,0.2058,0.6489,41126,153714,2388786,58.0,2347660
russia,2010,0.1646,0.1903,0.6451,47830,152813,2208872,46.1,2161042
russia,2011,0.1599,0.203,0.6371,46197,150918,2356285,51.0,2310088
russia,2012,0.1663,0.1881,0.6456000000000001,48420,152932,2183336,45.0,2134916
russia,2013,0.16,0.1991,0.6408999999999999,46232,151819,2311017,49.900000000000006,2264785
russia,2014,0.1685,0.191,0.6405,49184,151724,2216998,45.0,2167814
russia,2015,0.1708,0.186,0.6432,49983,152363,2158961,43.1,2108978
russia,2016,0.1702,0.1944,0.6354,49775,150516,2256462,45.300000000000004,2206687
russia,2017,0.1734,0.2,0.6266,50886,148431,2321463,45.6,2270577
russia,2018,0.1703,0.205,0.6247,49809,147981,2379500,47.7,2329691
russia,2019,0.1699,0.2021,0.6280000000000001,49670,148763,2345839,47.2,2296169
russia,2020,0.1568,0.2376,0.6055999999999999,45121,143456,2757899,61.1,2712778
russia,2021,0.1568,0.2376,0.6055999999999999,45121,143456,2757899,61.1,2712778
russia,2022,0.1568,0.2376,0.6055999999999999,45121,143456,2757899,61.1,2712778
russia,2023,0.1568,0.2376,0.6055999999999999,45121,143456,2757899,61.1,2712778
uk,1820,0.1659,0.248,0.5861000000000001,48281,138837,2878615,59.6,2830334
uk,1850,0.1646,0.25,0.5854,47830,138671,2901829,60.6,2853999
uk,1880,0.1541,0.266,0.5799,44183,137369,3087547,69.8,3043364
uk,1900,0.1455,0.31,0.5445,41196,128983,3598269,87.30000000000001,3557073
uk,1910,0.1515,0.3,0.5485,43280,129930,3482195,80.4,3438915
uk,1920,0.1932,0.2295,0.5772999999999999,57763,136753,2663879,46.1,2606116
uk,1930,0.2141,0.1944,0.5914999999999999,65022,140116,2256462,34.7,2191440
uk,1940,0.208,0.156,0.636,62903,150658,1810741,28.700000000000003,1747838
uk,1950,0.2218,0.1118,0.6664,67697,157859,1297698,19.1,1230001
uk,1960,0.2276,0.0887,0.6837,69711,161957,1029569,14.700000000000001,959858
uk,1970,0.2306,0.0742,0.6951999999999999,70753,164681,861263,12.100000000000001,790510
uk,1980,0.2219,0.0717,0.7064,67731,167334,832244,12.200000000000001,764513
uk,1981,0.2219,0.0717,0.7064,67731,167334,832244,12.200000000000001,764513
uk,1982,0.2203,0.0732,0.7064999999999999,67176,167358,849655,12.600000000000001,782479
uk,1983,0.2177,0.0727,0.7096,66273,168092,843852,12.700000000000001,777579
uk,1984,0.2155,0.0752,0.7092999999999999,65508,168021,872870,13.3,807362
uk,1985,0.212,0.0771,0.7109000000000001,64293,168400,894924,13.9,830631
uk,1986,0.2082,0.0791,0.7127000000000001,62973,168827,918138,14.5,855165
uk,1987,0.2068,0.0808,0.7124,62487,168756,937871,15.0,875384
uk,1988,0.2039,0.0858,0.7103,61479,168258,995908,16.1,934429
uk,1989,0.2064,0.0814,0.7121999999999999,62348,168708,944835,15.100000000000001,882487
uk,1990,0.193,0.0815,0.7255,57694,171859,945996,16.3,888302
uk,1991,0.1912,0.0821,0.7266999999999999,57068,172143,952960,16.6,895892
uk,1992,0.1951,0.0774,0.7275,58423,172333,898406,15.3,839983
uk,1993,0.1918,0.0872,0.7210000000000001,57277,170793,1012158,17.6,954881
uk,1994,0.1927,0.0992,0.7081000000000001,57589,167737,1151446,19.900000000000002,1093857
uk,1995,0.1882,0.1003,0.7114999999999999,56026,168543,1164214,20.700000000000003,1108188
uk,1996,0.1866,0.1148,0.6986,55471,165487,1332520,24.0,1277049
uk,1997,0.1894,0.1192,0.6914,56443,163781,1383592,24.5,1327149
uk,1998,0.1866,0.1281,0.6853,55471,162336,1486897,26.8,1431426
uk,1999,0.183,0.1201,0.6969000000000001,54220,165084,1394039,25.700000000000003,1339819
uk,2000,0.1886,0.1163,0.6951,56165,164658,1349931,24.0,1293766
uk,2001,0.1859,0.1157,0.6983999999999999,55228,165439,1342966,24.3,1287738
uk,2002,0.1884,0.1185,0.6930999999999999,56096,164184,1375467,24.5,1319371
uk,2003,0.1822,0.1296,0.6882,53943,163023,1504308,27.8,1450365
uk,2004,0.1851,0.1284,0.6865000000000001,54950,162620,1490379,27.1,1435429
uk,2005,0.1821,0.141,0.6769,53908,160346,1636632,30.3,1582724
uk,2006,0.181,0.145,0.6739999999999999,53526,159659,1683061,31.400000000000002,1629535
uk,2007,0.1845,0.1454,0.6701,54741,158736,1687704,30.8,1632963
uk,2008,0.1871,0.1393,0.6736,55644,159565,1616899,29.0,1561255
uk,2009,0.1771,0.1415,0.6814,52171,161412,1642435,31.400000000000002,1590264
uk,2010,0.1988,0.1214,0.6798000000000001,59708,161033,1409128,23.6,1349420
uk,2011,0.1957,0.1301,0.6742,58631,159707,1510112,25.700000000000003,1451481
uk,2012,0.1888,0.1265,0.6847,56235,162194,1468325,26.1,1412090
uk,2013,0.1837,0.137,0.6793,54464,160915,1590202,29.1,1535738
uk,2014,0.1941,0.1324,0.6735,58076,159541,1536809,26.400000000000002,1478733
uk,2015,0.1993,0.1224,0.6783,59882,160678,1420735,23.700000000000003,1360853
uk,2016,0.201,0.124,0.675,60472,159896,1439307,23.8,1378835
uk,2017,0.2044,0.1331,0.6625,61653,156935,1544934,25.0,1483281
uk,2018,0.2029,0.1296,0.6675000000000001,61132,158120,1504308,24.6,1443176
uk,2019,0.2036,0.1261,0.6703,61375,158783,1463683,23.8,1402308
uk,2020,0.2005,0.131,0.6685,60299,158357,1520558,25.200000000000003,1460259
uk,2021,0.2005,0.131,0.6685,60299,158357,1520558,25.200000000000003,1460259
uk,2022,0.2005,0.131,0.6685,60299,158357,1520558,25.200000000000003,1460259
uk,2023,0.2005,0.131,0.6685,60299,158357,1520558,25.200000000000003,1460259
usa,1820,0.14,0.16,0.7,39285,165818,1857171,47.2,1817886
usa,1850,0.11,0.17,0.72,28866,170556,1973244,68.3,1944378
usa,1880,0.1504,0.117,0.7326,42898,173541,1358056,31.6,1315158
usa,1900,0.1453,0.155,0.6997,41126,165747,1799134,43.7,1758008
usa,1910,0.151,0.2043,0.6446999999999999,43106,152719,2371375,55.0,2328269
usa,1913,0.151,0.2043,0.6446999999999999,43106,152719,2371375,55.0,2328269
usa,1914,0.1491,0.2091,0.6417999999999999,42446,152032,2427090,57.1,2384644
usa,1915,0.1513,0.2029,0.6458,43210,152979,2355125,54.5,2311915
usa,1916,0.1473,0.2136,0.6391,41821,151392,2479323,59.2,2437502
usa,1917,0.1461,0.2131,0.6407999999999999,41404,151795,2473519,59.7,2432115
usa,1918,0.1476,0.1968,0.6556,41925,155301,2284320,54.400000000000006,2242395
usa,1919,0.1437,0.2164,0.6398999999999999,40571,151582,2511824,61.900000000000006,2471253
usa,1920,0.1482,0.1913,0.6605,42134,156461,2220480,52.7,2178346
usa,1921,0.1383,0.1915,0.6702,38695,158759,2222801,57.400000000000006,2184106
usa,1922,0.142,0.1858,0.6722,39980,159233,2156640,53.900000000000006,2116660
usa,1923,0.1488,0.177,0.6741999999999999,42342,159707,2054495,48.5,2012153
usa,1924,0.1414,0.1847,0.6739,39772,159636,2143871,53.900000000000006,2104099
usa,1925,0.1373,0.2068,0.6559,38348,155372,2400393,62.5,2362045
usa,1926,0.1356,0.2194,0.645,37757,152790,2546645,67.4,2508888
usa,1927,0.1378,0.2126,0.6496,38521,153879,2467716,64.0,2429195
usa,1928,0.135,0.2229,0.6421,37549,152103,2587271,68.9,2549722
usa,1929,0.1382,0.2218,0.64,38660,151605,2574503,66.5,2535843
usa,1930,0.1389,0.194,0.6671,38903,158025,2251820,57.800000000000004,2212917
usa,1931,0.1382,0.1676,0.6942,38660,164444,1945386,50.300000000000004,1906726
usa,1932,0.1322,0.1651,0.7027,36576,166458,1916368,52.300000000000004,1879792
usa,1933,0.1329,0.1751,0.692,36819,163923,2032441,55.2,1995622
usa,1934,0.1317,0.1906,0.6777,36403,160536,2212355,60.7,2175952
usa,1935,0.1382,0.1933,0.6685,38660,158357,2243694,58.0,2205034
usa,1936,0.1388,0.2094,0.6517999999999999,38869,154401,2430572,62.5,2391703
usa,1937,0.1409,0.2067,0.6524,39598,154543,2399232,60.5,2359634
usa,1938,0.142,0.1864,0.6716,39980,159091,2163604,54.1,2123624
usa,1939,0.138,0.1957,0.6663,38591,157835,2271552,58.800000000000004,2232961
usa,1940,0.139,0.2087,0.6523,38938,154519,2422447,62.2,2383509
usa,1941,0.1451,0.2158,0.6391,41057,151392,2504859,61.0,2463802
usa,1942,0.1768,0.2059,0.6173,52067,146228,2389947,45.900000000000006,2337880
usa,1943,0.1879,0.1859,0.6262000000000001,55922,148336,2157800,38.5,2101878
usa,1944,0.1967,0.1535,0.6498,58979,153927,1781723,30.200000000000003,1722744
usa,1945,0.1582,0.1425,0.6993,45607,165653,1654043,36.2,1608436
usa,1946,0.1712,0.1428,0.6859999999999999,50122,162502,1657525,33.0,1607403
usa,1947,0.1729,0.1497,0.6774,50712,160465,1737615,34.2,1686903
usa,1948,0.1739,0.1631,0.663,51060,157054,1893153,37.0,1842093
usa,1949,0.171,0.1572,0.6718,50053,159138,1824670,36.4,1774617
usa,1950,0.1754,0.1669,0.6577,51581,155798,1937261,37.5,1885680
usa,1951,0.1838,0.16,0.6562,54498,155443,1857171,34.0,1802673
usa,1952,0.1896,0.1497,0.6607000000000001,56513,156509,1737615,30.700000000000003,1681102
usa,1953,0.1931,0.1401,0.6668000000000001,57728,157954,1626185,28.1,1568457
usa,1954,0.1861,0.1395,0.6744000000000001,55297,159754,1619221,29.200000000000003,1563924
usa,1955,0.1877,0.1461,0.6662,55853,157812,1695829,30.3,1639976
usa,1956,0.1928,0.1384,0.6688000000000001,57624,158428,1606453,27.8,1548829
usa,1957,0.1921,0.1353,0.6726000000000001,57381,159328,1570470,27.3,1513089
usa,1958,0.1842,0.1268,0.689,54637,163213,1471808,26.900000000000002,1417171
usa,1959,0.1818,0.1321,0.6861,53804,162526,1533326,28.400000000000002,1479522
usa,1960,0.1822,0.1267,0.6910999999999999,53943,163710,1470647,27.200000000000003,1416704
usa,1961,0.1772,0.1253,0.6975,52206,165226,1454397,27.8,1402191
usa,1962,0.1932,0.1284,0.6784,57763,160702,1490379,25.8,1432616
usa,1963,0.1894,0.1298,0.6808,56443,161270,1506630,26.6,1450187
usa,1964,0.1858,0.1311,0.6831,55193,161815,1521719,27.5,1466526
usa,1965,0.1903,0.1303,0.6794,56756,160939,1512433,26.6,1455677
usa,1966,0.1948,0.1297,0.6755,58319,160015,1505469,25.8,1447150
usa,1967,0.2073,0.1237,0.6689999999999999,62660,158475,1435825,22.900000000000002,1373165
usa,1968,0.2061,0.1261,0.6678,62244,158191,1463683,23.5,1401439
usa,1969,0.2124,0.116,0.6716,64432,159091,1346449,20.8,1282017
usa,1970,0.2112,0.107,0.6818,64015,161507,1241983,19.400000000000002,1177968
usa,1971,0.2044,0.1105,0.6850999999999999,61653,162289,1282608,20.8,1220955
usa,1972,0.2024,0.1108,0.6868,60958,162691,1286091,21.0,1225133
usa,1973,0.2043,0.1088,0.6869,61618,162715,1262876,20.400000000000002,1201258
usa,1974,0.21,0.1037,0.6863,63598,162573,1203679,18.900000000000002,1140081
usa,1975,0.2041,0.1043,0.6916,61549,163829,1210643,19.6,1149094
usa,1976,0.2053,0.1036,0.6910999999999999,61966,163710,1202518,19.400000000000002,1140552
usa,1977,0.2027,0.1058,0.6915,61063,163805,1228054,20.1,1166991
usa,1978,0.2024,0.1035,0.6940999999999999,60958,164421,1201357,19.700000000000003,1140399
usa,1979,0.2034,0.1086,0.688,61306,162976,1260554,20.5,1199248
usa,1980,0.2008,0.1042,0.6950000000000001,60403,164634,1209482,20.0,1149079
usa,1981,0.1969,0.1067,0.6964,59048,164966,1238501,20.900000000000002,1179453
usa,1982,0.1916,0.1099,0.6985,57207,165463,1275644,22.200000000000003,1218437
usa,1983,0.1832,0.115,0.7018,54290,166245,1334841,24.5,1280551
usa,1984,0.1796,0.1215,0.6989000000000001,53039,165558,1410289,26.5,1357250
usa,1985,0.1782,0.1227,0.6990999999999999,52553,165605,1424218,27.1,1371665
usa,1986,0.1761,0.1198,0.7041,51824,166790,1390556,26.8,1338732
usa,1987,0.1736,0.1324,0.6940000000000001,50956,164397,1536809,30.1,1485853
usa,1988,0.1687,0.1521,0.6792,49254,160891,1765473,35.800000000000004,1716219
usa,1989,0.1698,0.1469,0.6833,49636,161862,1705115,34.300000000000004,1655479
usa,1990,0.1685,0.1471,0.6844,49184,162123,1707436,34.7,1658252
usa,1991,0.1671,0.1365,0.6963999999999999,48698,164966,1584399,32.5,1535701
usa,1992,0.16,0.1468,0.6931999999999999,46232,164208,1703954,36.800000000000004,1657722
usa,1993,0.1611,0.1415,0.6974,46614,165202,1642435,35.2,1595821
usa,1994,0.1617,0.1402,0.6980999999999999,46822,165368,1627346,34.7,1580524
usa,1995,0.1574,0.1452,0.6974,45329,165202,1685382,37.1,1640053
usa,1996,0.1547,0.1525,0.6928000000000001,44391,164113,1770116,39.800000000000004,1725725
usa,1997,0.1524,0.16,0.6876,43592,162881,1857171,42.6,1813579
usa,1998,0.1528,0.1632,0.6839999999999999,43731,162028,1894314,43.300000000000004,1850583
usa,1999,0.1514,0.1676,0.681,43245,161318,1945386,44.900000000000006,1902141
usa,2000,0.1506,0.1734,0.6759999999999999,42967,160133,2012709,46.800000000000004,1969742
usa,2001,0.1531,0.1659,0.681,43835,161318,1925654,43.900000000000006,1881819
usa,2002,0.154,0.161,0.6849999999999999,44148,162265,1868778,42.300000000000004,1824630
usa,2003,0.1509,0.1632,0.6859,43071,162478,1894314,43.900000000000006,1851243
usa,2004,0.1478,0.1706,0.6816,41995,161460,1980208,47.1,1938213
usa,2005,0.1432,0.1806,0.6762,40397,160181,2096281,51.800000000000004,2055884
usa,2006,0.1408,0.1852,0.6739999999999999,39563,159659,2149675,54.300000000000004,2110112
usa,2007,0.1431,0.1838,0.6731,40362,159446,2133425,52.800000000000004,2093063
usa,2008,0.1429,0.1793,0.6778,40293,160560,2081192,51.6,2040899
usa,2009,0.1425,0.167,0.6905,40154,163568,1938422,48.2,1898268
usa,2010,0.1387,0.1789,0.6823999999999999,38834,161649,2076549,53.400000000000006,2037715
usa,2011,0.1356,0.1808,0.6836,37757,161933,2098603,55.5,2060846
usa,2012,0.1315,0.1949,0.6736,36333,159565,2262266,62.2,2225933
usa,2013,0.1345,0.1846,0.6809000000000001,37375,161294,2142711,57.300000000000004,2105336
usa,2014,0.1314,0.1897,0.6789000000000001,36298,160820,2201908,60.6,2165610
usa,2015,0.1321,0.1889,0.6789999999999999,36542,160844,2192622,60.0,2156080
usa,2016,0.1295,0.1866,0.6839,35639,162005,2165925,60.7,2130286
usa,2017,0.1348,0.1905,0.6747,37479,159825,2211194,58.900000000000006,2173715
usa,2018,0.1334,0.1924,0.6742,36993,159707,2233248,60.300000000000004,2196255
usa,2019,0.1358,0.1904,0.6738,37827,159612,2210033,58.400000000000006,2172206
usa,2020,0.137,0.1817,0.6813,38243,161389,2109050,55.1,2070807
usa,2021,0.1346,0.1988,0.6666000000000001,37410,157906,2307535,61.6,2270125
usa,2022,0.1334,0.2073,0.6593,36993,156177,2406197,65.0,2369204
usa,2023,0.1344,0.2073,0.6583,37340,155940,2406197,64.4,2368857
